EA map/red_brick.xpm
SO map/green_brick.xpm
NO map/yellow_brick.xpm
WE map/blue2_brick.xpm

C 12,2,40
F 0,188,255

111111111111111
100000010000001
101110000011101
1011000N0001101
101000000000101
100000000000001
110001111100011
100000111000001
101000010000101
101100000001101
101110000011101
100000010000001
111111111111111