NO map/brick_w-16.xpm
EA map/brick_w-16.xpm
SO map/brick_w-16.xpm
WE map/brick_w-16.xpm

F 60,60,60
C 32,32,32

111111111111111111111
100000000000000000001
100000011100000000001
100000000100000000001
100000000100000000001
100000000000000000001
100000000000000000001
1000000000000E1000001
100000000000000000001
100000000000000000001
101000001000000000001
111111111111111111111