1111111111111111
1000000000000002
1000000000000001
100000E000000004
1000000000000003
1000000000000002
1111111111111111