C 64,63,65
F 33,31,32

EA map/red_brick.xpm
SO map/green_brick.xpm
NO map/yellow_brick.xpm
DO map/GREGRGB.xpm
WE map/blue2_brick.xpm

1111
100111
1S0O01
111111