C 64,63,65
F 33,31,32

SO map/RL-128x.xpm
NO map/blue2_brick.xpm
WE map/RL-128x.xpm
EA map/wall_anim_gray_debug.xpm
DO map/GREGRGB.xpm


11111 11111  111111
1000111000111100001
100S0D00000D0000001
1000111000111110001
11011 11011   11011
 1O1   1D1     1D1
11011 11011   11011
1000111000111110001
10000D00000D0000001
1000111000111110001
11011 11011   11011
 1D1   1D1     1D1
11011 11011   11011
1000111000111110001
10000D00000D0000001
1000111000111110001
11111 11111   11111